...###......###################
..##.#*####..................##
.##..###..#...?..#...........##
##........#.......####....#####
#.@....#..#......#....#....####
###..###..#######...........###
..#..#...........#........?..##
.##....######....#.....#......#
.#...?..##.....?......##..^..##
.#.....##............####...###
.##############################